W W W W W W W W W W
W W W W W W W W W W
W W W W W W W W W W
W W W W W W H W W W
W E E E E E E W W W
W E E E E E E W W W
W E E W W W W W W W
W W W W W W W W W W
W W W W W W W W W W
W W W W W W W W W W
W W W W W W W W W W
W W W W W W W W W W
W W W W W W W W W W
W W W W W W H W W W
W E E E E E E W W W
W E B E E E E W W W
W E P W W W W W W W
W W W W W W W W W W
W W W W W W W W W W
W W W W W W W W W W
1