W W W W W W W W W W
W E E E E E E E E W
W E E E E E E E E W
W E E W W W W W E W
W E E W E E W W E W
W E E W E W W W H W
W E E W E E E W W W
W E E E E E E W W W
W E E E E E E W W W
W W W W W W W W W W
W W W W W W W W W W
W E E E E E E E E W
W E E E E E E E E W
W E E W W W W W E W
W E E W E P W W E W
W E E W B W W W H W
W E E W E E E W W W
W E E E E E E W W W
W E E E E E E W W W
W W W W W W W W W W
1